v2
map 4
1 64,17
0000000000000000000000000.....#####.....000000000000000000000000
0000000000000000000000000...###~.6###...000000000000000000000000
0000000000000000000000000..##.......##..000000000000000000000000
0000000000000000000000000..##".....;##..000000000000000000000000
0000000000000000000000000...##.....##...000000000000000000000000
0000000000000000000000000.##1##.V.##2##.000000000000000000000000
0000000000000000000000000..###..3..###..000000000000000000000000
0000000000000000000000000...............000000000000000000000000
0000000000000000000000000000000...000000000000000000000000000000
0000000000000000000000000000000...000000000000000000000000000000
0000000000000000000000000000000...000000000000000000000000000000
0000000000000000000000000000000...000000000000000000000000000000
0000000000000000000000000000000...000000000000000000000000000000
0000000000000000000000000000000...000000000000000000000000000000
0000000000000000000000000000000...000000000000000000000000000000
0000000000000000000000000000000...000000000000000000000000000000
0000000000000000000000000000000...000000000000000000000000000000
==
