v2
map 1
1 64,16
################################################################
################################################################
################################################################
################................................################
############........................................############
##########............................................##########
##########............................................##########
XPP...........................................................##
XPP...........................................................##
##########............................................##########
##########............................................##########
############........................................############
################................................################
################################################################
################################################################
################################################################
==
