v2
map 0
1 64,64
^^^^^^^^^^^^^^^^^^^^^^^^^^^^^^^^^^^^^^^^^^^^^^^^^^^^^^^^^^^^^^^^
+^^^^^%^^^^^^^^^^^^^---^^^^^^^^^^^^^^^^((((((------^^^^^^^^^~~^^
++^^~^^v^^^---------------((((((((((((((((((--------^^^^^^~~~~~^
+++^^~^^v^^------------(((((((((((((((((((((((((------^^^~~~~|~^
++++^^~^^v^------((((((((((((((^^^((((((((((------------^^^~v~~^
++++^~^^v^^----------((((((((((^5^((((((((-------.......a~~^~~~^
++++^^~d^^--------------(((((((^(^(((((---------.------~~^^^^^^^
+++----~.......-----------((((((((((-----------.------~~--^^^^^^
++++--~--------.......------((((((((((((------.-------~^^^^^^^^^
+++++++---------------.......(((((((((-------.--------~~--^^^^^^
+++++++----------------------......-.........--------~~-----^^^^
+++++++++--------------((((((((((((b(((((((------^^3~~------^^^^
++++++++++++---------------(((((((.(((((((------^^^~~-------^^^^
++++++++++-------((((((((((((((((.(((((((((((((^^^-~~-------^^^^
+++++++----------------(((((((((.(((((((((---^^^----~~------^^^^
++++++++++++---------------((((.(((((((((--^^^-----~~---^^^^^^^^
++++++++++++++++--------------.--------^^^^^------~~---^^^^^^^^^
+++++++++++++++++++----------.------^^^^---------~~---^^^^^^^^^^
++++++++++++++++++++++++----.---v^^^^^^^^-((((--~~----------^^^^
+++++++++++++++++++++++++++O--^^^v^^^((((((((((((~~---^^^^^^^^^^
+++++++++++++-------------.----^^^v^(((((((((((((~~(----^^^^^^^^
++++++++++---------------.-^^^^^^(((((((((((((((~~((--------^^^^
++++++++++++++++++++++...-^*^^^^(((((((((((((((~~((((((-----^^^^
++++++++++++++++++-...-----^^^-(((((((((((((((~~(((((((((---^^^^
+++++++++++++-----.------^^^^((((((((((((((((~~(((((((((----^^^^
++++++++++-------.-----^^^^--((((((((((((((~~~(((((((((-----^^^^
++++++++++++++++.------^^^-------(((((((((~~(((((((((((((---^^^^
+++++++++++++++.------^^^---((((((((((((((~~(((((((--------^^^^^
+++++++++++++++.-----^^^(((((((((((((((~~~~(((((((-------^^^^^^^
+++++++++++++--.------vvv(((((((((((~~~~(((((((((-------^^^"^^^^
+++++++++++++++.-----^1^-------((~~~~(((((((((((((((-^^^^^""^^^^
+++++++++++++++.------^^^-----((~~~((((((((((((((((-^^^"""""^^^^
++++++++++-----.----^^^------(((((~~(((((((((---^^^^""""""""^^^^
++++++++-------.----^^^-(((((((((((~((((((((((((--^"""""""^^^^^^
++++++---------.-----^^^(((((((((((~~((((((((((--^^^""""""""$^^^
+++++++++++++++.----^^-(((((((((((~~((((((((((--^^^"""""""""^^^^
+++++++++++++++.-----^^^^((((((((~~(((((((((-------""""""""^^^^^
++++++++++++---.----^^^(((((((~~~~(((((((-----^^""""""""""""^^^^
+++++++++++++++.---^^^-(((~~~~~(((((((------^^^"""""""""""""^^^^
+++++++++++++++.---^^^^~~~~(((((----------^^^"""""""""""""""^^^^
++++++++++c....-...~~~~~-((((((((((-----^^^^""""""""""""""""^^^^
++++++++++++++~~~~~.f==-------------^^^^""""""""""""""""^^^^^^^^
++++++++++++=====~==~======----^^^^^^^^^"""""""""""""""""""^^^^^
+++++++++++=====~====~====---------------e""""""""""""""^^^^^^^^
+++++++++++++++~====~====-^^-------^^^^^^"""""""""""""""""""^^^^
+++++++++++++++====~====-^^------^^^"""""""""2"""""""""""---^^^^
+++++++++++++=====~4~===---^-----^^"""""""""""---^^^^-------^^^^
++++++++++=======~==~====---------^^"""""""""--^^-----------^^^^
+++++++++++++===~====~====--^--------""""""---^^-)))-^^-----^^^^
++++++++++++===~======~===---^^^^------------^^~)))))--^^---^^^^
+++++++++++++++======~======-----^^^------^----)~)))))--^^^-^^^^
+++++++++++++++=====~===^=======--~~~^^^-^---))))~)K))))----^^^^
++++++++++++++=====~=============~~=~~~~^^))))))))~))))))))-^^^^
+++++++++++++++===~=~~~~~~=====~~~~====^^^^)))))))~)))))))^^^^^^
++++&++++++++++==~========~~~~~~==~~~~===^^^)))))))~))))))))^^^^
+++++=+++++++===~=~=========~===~~===~~~~~~^^)))))))~)))))^^^^^^
++++++=++++++++~===~===^===~===~=====~====^^^^)))))))~))))))^^^^
+++++++=+++++++====~~=====~===^=======~====^^)))))))))~)))))^^^+
++++++++=+========~==~===~===^!^=======~===^^^))+++)))~)))^^^^++
+++++++++=++=====~====~=~~====^=======~=~=^^^)))+6+))~)))^^^^+++
++++++++++++====~======~==~++++======~===~==^^))+++))~^^^^^+++++
++++++++++++++++========~++++++++===~====~^^^^^^^+^^^^~^^+++++++
++++++++++++++++++++++++++++++++++++++++++++++++++++++++++++++++
++++++++++++++++++++++++++++++++++++++++++++++++++++++++++++++++
==
