v2
map 5
1 64,25
################################################################
################################.###############################
################################.###############################
################################.###############################
###############################G.G##############################
###############################...##############################
###############################...##############################
##############################G...G#############################
##############################.....#############################
##############################.....#############################
#############################G.....G############################
#############################.......############################
#############################.......############################
############################G.......G###########################
###########################..e.....e..##########################
#########################....e.....e....########################
#########################....e.....e....########################
#########################.....n...n.....########################
##########################....n...n....#########################
###########################.....5.....##########################
#############################..T.T..############################
###############################.<.##############################
################################################################
################################################################
################################################################
==
