v2
map 7
6 22,14
z"""""""""""""""""""""
....................."
""""""""""""""""""""."
"?"O"?""?.""""".?.."."
"-".-.."".."....".""."
".""""..""."""..".".."
"........"...""."...""
""".""".""."""".""""""
"..."?"......?"....-?"
"."""-""""""."".""""""
"."?-...."?-."..">-.."
".""""""."""""..""""."
"...................."
""""""""""""""""""""""
===
z"""""""""""""""""""""
.....".?"..."."......"
".""."-""."...".""""."
".."....".""".".""?"."
"..""""."..."...-.."."
"...."".""".".""""""."
""."."..-?-."."?-...."
".."."."""".".""".".""
".""...""..."........"
".."."""..".""""""."."
""."-"...""....-O">"."
"..-?"."""""-"""""""."
"?.""".....-?"?-....."
""""""""""""""""""""""
===
z"""""""""""""""""""""
.........-.-........."
".""""""""."""""""""."
"."..-..?"......".?"."
".".""."""""""".-.."."
".".."?.->"..."."-""."
"."".""""""."......"."
".""."?."?".""""".."."
"."?.".?".-."?-O""."."
"."".""-"""."-""".."."
".".........".....""."
".""""""""".""""""""."
".........-.-.......?"
""""""""""""""""""""""
===
z"""""""""""""""""""""
..-."................"
"."?"-""""".".""-"""."
"-"""....?".".?"..?"."
".-.""""""."""""""""."
"-"........".....-O"."
".""""""""""."""""""."
"."....".".-......."-"
".""."..."."-""""".-?"
".?"."""."."."..."""-"
"."".">"."?"."."."..."
".".."-"."""."-".-.?."
"...""......."?"."..."
""""""""""""""""""""""
===
z"""""""""""""""""""""
....-?"..."?-........"
"."""-"."."-""""""."."
"."?".".".".""....."."
".""".".".".."".""""."
"......."."".."..-O"."
".""""".".""".""""""."
"...-?".".........."."
"."""""."."""""""--"."
"."?.."."......>"??"."
"."."...".""""".""""."
"."."""."."?""....".."
"...-?"...".-..""...""
""""""""""""""""""""""
===
z"""""""""""""""""""""
....."...".-..."?"..."
".."..."..."""."..."."
".""""""""..."."""""."
"."......"""."."..."."
""""""""..."."..."."."
"O""."."""..."""?"..."
"."......"....."""""""
"."-"".".".""".....-?"
".".?"."-".">"""""""""
"."?."."?".".".....-?"
".""""."""."-"."""""""
"..................-?"
""""""""""""""""""""""
===
