v2
map 9
1 64,16
################################################################
#3##############################################################
##DDDDDDDDDDDDDDDDDDDDDDDDDDDDDD#BBBBBBBBBBBBBBBBBBBBBBBBBBBBB##
##DDDDDDDDDDDDDDDDDDDDDDDDDDDDDD#BBBBBBBBBBBBBBBBBBBBBBBBBBBBB##
##DDDDDDDDDDDDDDDDDDDDDDDDDDDDDD#BBBBNBBBBBBBBBBBBBBBBBBBBBBBB##
##DDDDDDDDDDDDDDDDDDDDDDDDDDDDDD#BBBBBBBBBBBBBBBBBBBBBBBBBBBBB##
##DDDDDDDDDDDDDDDDDDDDDDDDDDDDDD#BBBBBBBBBBBBBBBBBBBBBBBBBBBBB##
##DDDDDDDDDDDDDDDDDDDDDDDDDDDDDD#BBBBBBBBBBBBBBBBBBBBBBBBBBBBB##
X.DDDDDDDDDDDDDDDDDDDDDDDDDDDDDD.BBBBBBBBBBBBBBBBBBBBBBBBBBBBB##
X.DDDDDDDDDDDDDDDDDDDDDDDDDDDDDD.BBBBBBBBBBBBBBBBBBBBBBBBBBBBB##
##DDDDDDDDDDDDDDDDDDDDDDDDDDDDDD#BBBBBBBBBBBBBBBBBBBBBBBBBBBBB##
##DDDDDDDDDDDDDDDDDDDDDDDDDDDDDD#BBBBBBBBBBBBBBBBBBBBBBBBBBBBB##
##DDDDDDDDDDDDDDDDDDDDDDDDDDDDDD#BBBBBBBBBBBBBBBBBBBBBBBBBBBBB##
##DDDDDDDDDDDDDDDDDDDDDDDDDDDDDD#BBBBBBBBBBBBBBBBBBBBBBBBBBBBB##
##############################################################3#
################################################################
==
